1111111111
1110011101
1000P1C101
1000011111
100C0001E1
1111111111