10111111001111111111
10000000000000000001
10000000000000000001
1P000000E1100000C001
10000000000000000001
11011111111111111111




