11111111111111111111
100000000E0000000001
10000000000000000001
1P00000001100000C001
10000000000000000001
11111111111111111111
