111111111111
111111110001
1001P1C10001
100000000001
100C000101E1
111111111111