11111111111111111111
10P00000000000000001
100000P0000000000001
10000000011000000001
100000000000EE000001
11111111111111111111
