1111111111111111111
1000000000000000001
1000000000000000001
1P000000011E00000C1
1000000000000000001
1111111111111111111