111111111111111111111
100000000000000000001
100000000000000000001
100P000C0000000000001
1000E01110000000000C1
101110000011100000011
101C00000000000C00001
111111111111111111111