1111111111111111111
100000000C100000001
10E0111100100111101
111110010000C100101
100000C111111111101
1C00100100000000001
1110111101C101C1001
11P0000000000000N01
1111111111111111111