111111111111111111111
100000000000000000001
10E000000000000000001
111110000100000C00001
100000011111000100001
1C0000110001000000001
111000100C011000001C1
100011100100000011111
1P001C0000000000000C1
111111111111111111111