111111111111111111111
100000000000000000001
10E000000000000N00001
111110000100000C00001
100000011111000100001
1C0000110C01000000001
1110001000011000001C1
111111111100000011111
1P00000000000000000C1
111111111111111111111