11111111111111111111
10000000000000000001
1000000000000000N001
100P000C000000000001
10000011100000000001
10111000001110000011
101000000000000E0011
11111111111111111111