111111111111111111111
100000000000000000001
100000000000000000001
100P000C0000000000001
1000E0111000000000001
101110000011100000011
101000000000000000001
111111111111111111111