111111111111111111111
100000000000000000001
10N0000C000000C0000P1
100111111111111111111
100000000C00000000001
111111111111111111001
101C000100010C0100001
101000010001000100001
101101010100010001111
1E0001000100010001001
111111111111111111101