111111111111
111111110001
100100110001
10000P000101
100C000101E1
111111111111