111111111
1PCE000N1
1000000C1
111111111
